#######################################################################
#........#..#..$.....$#....#.......#......$........................*..#
#..@........#.........#$...#.......#!.................................#
#...........#....#....#....#...#...########....########################
######..$#..#....#....#....#...#..........#........................$..#
#.*..#...#..#....#....#........#..........#...........................#
#....#...#..#....#....#........#...#..#####....##################.....#
#..###...####.$..#....#....#...#...#..#$.......#................#.....#
#................#.........#...#...#.$#.......$#................#.....#
#................#.$.......#...#...####..#######...##########...#.....#
############################...#.........#$........#$.....*.#...#.....#
#............#.....*...........#*........#.........#........#...#..*..#
#............#.................###########.....#...#....#####...#.....#
#..####..$####......############..$............#.*.#............#.....#
#..#.*#.............#$......................########$...........#.....#
#.....#..$......#...#.......................#......#....#####...#.$...#
#.....#.........#...#....#######...####...###......#...$....#...#.....#
#######.....#########...$#.......^...h#.....#.*.#..#........#...#....$#
#...........#$...........#..*.........#.....#####..#....#####...#.....#
#.$.......*.#............##############............#....#h......#..$..#
#.....#######...#....#......#............$.........#....#.......#.....#
#.....#.$.......#....#......#................#.....#....#########.....#
#...$.#.........#....#...........#####.....$.#...###................$.#
#..>..#####...$.#..*.#............#..........#.....#$.................#
#..<..#...#.....######....####....#.....######.....####################
#.....#...................#.*.....#..........###...#.................$#
#.........................#.......####.....$.#$....#*.................#
#........#########....#############.......####.....#######$..######...#
#..#.........*...#...........................###.............#.*......#
#..#.............#..........................!#...............#........#
#######################################################################