###########################
#.$.*......!.....$........#
#......$..................#
#............>............#
#.....####.......####.....#
#.....#............$#.....#
#.....#.*....@......#*....#
#.$...#.............#.....#
#.....#......^......#.....#
#.....#.$...........#.....#
#.....###############.....#
#..*.........<.....$....h.#
#.........................#
#.......$.................#
###########################