###############................#################
#.............#................#...............#
#.............##################...............#
#.....................p........................#
#......@.................p.....................#
#.............##################...............#
#.............#................#...............#
###############................#################