############################
#............#..........*..#
#.@........$.#...$.........#
#............#....#####....#
#......#.....#........#....#
########.....#........#....#
#............####.....#....#
#............#$.......#....#
#.....#....###.....####...$#
#.....#....#....<..!..#....#
#.$...#....#....>.....#....#
#.....#....#..^.......#....#
#.....#.........#######....#
#..*..#.........#.h.....$..#
#######......####..........#
#..............#......######
#..*........$..#.$......*..#
#..............#...........#
############################