###########################
#.$.*......!.....$........#
#......$..................#
#............>............#
#.....#####......####.....#
#.....#............$#.....#
#.....#.*....@......#*....#
#.$...#.............#.....#
#.....#.............#.....#
#.....#.$...........#.....#
#.....###############.....#
#..*.........<.....$....h.#
#..^......................#
#.......$.................#
###########################