.................................
.................................
...###########################...
...#.$.h.......!.....$......^#...
...#......$..................#...
...#.........................#...
...#.....$...........$.......#...
...#..................$......#...
...#.......*....@.......*....#...
...#.........................#...
...#.........................#...
...#.....$...................#...
...#......p..................#...
...#..*..........$...$.......#...
...#.........................#...
...#.......$.................#...
...###########################...
.................................
..................