###########################
#.$.h.......!.....$......^#
#......$..................#
#.........................#
#.....$...........$.......#
#..................$......#
#..$....*....@.......*....#
#.........................#
#............>............#
#.....$......<............#
#.........................#
#..*..........$...$.......#
#.........................#
#.......$.................#
###########################