#######################################################################
#@..#.....#...............$..................#.^........#............*#
#...#........................................##.........#.............#
#...#..#.....$#..#####################...>...#...##....$#.$...$.#######
#...#..###########.!.................#.$.<...##...#$....#.............#
#...#................................#............#.....######..$...$.#
#...#..................##########$...#!....$......#....$#.............#
#...############...#...#.!......#....##############$....#........######
#...#*......#$.....#...#*.......#...$#$..............*..#.$...........#
#...#......$#.....##...#######..#$...#......$...........#.............#
#.......#...#..#...#............#....#..........###############$...$..#
#......$#...##....$#............#...$#...$.........#..................#
#########$..#......##############$...#######.......#..................#
#...........#...####.................#........$....#...$...############
#...........##.....#.................#.........#####*........#........#
#$..#########.$...$#....#$..#........#..$..........#####............$.#
#..................#....#...################....$..#.$.....$...$.#....#
#..................#.*..#........#$.......$#...............#.....#....#
#..######################...$....#.........#..$..........$.#!....#.*..#
#..........#*.......#.$..........#.$..h....############################
#..........#........#...........$#..............#..........#..........#
#....#$....#$...#...#....#####...#*.............#.....................#
#....#...$.#....#...#........#...##########$....#...#####.......#!....#
#...$#..........#...###......#$...........#...$.#####.$.#....##########
#....#..........#...#........#............#.....#.......#.............#
#$...############...#........#...#...#....#.....#.......#.............#
#..............*#...#.....########...#.............#$...#########..#..#
#...............#.........#.....!#.*.#.............#.........#..#*.#..#
#######$....#####.......###......#####################..$....#..####..#
#...........$...#########....$...#..........#$............#...........#
#...............#.......#........#..........#.............#...........#
#$..#############..........#....$#$..####..$#....$#...#################
#...#.h.........#...$#.....#.....#......#...#..*..#$.........#.$.#.*..#
#...#...........#....#######$...........#$..#######..............#...$#
#........#.$.........#........#.....#$..#............#...$#...........#
#.......*#.........$.#!..........#......#............#$...#...........#
#######################################################################