#############################################################################
#..@........................................................................#
#..#........................................................................#
#..#........................................................................#
#..#........................................................................#
#..#........................................................................#
#..#........................................................................#
#..#........................................................................#
#..####.....................................................................#
#...........................................................................#
#...........................................................................#
######...#..................................................................#
#....#...#..................................................................#
#....#...#..................................................................#
#..###...#..................................................................#
#........#..................................................................#
#...........................................................................#
##########..................................................................#
#...........................................................................#
#...........................................................................#
#...........................................................................#
#...........................................................................#
#...........................................................................#
#############################################################################