###########################
#.$.h.......!.....$......^#
#......$..................#
#.........................#
#.....$...........$.......#
#..................$......#
#.......*....@.......*....#
#.........................#
#............>............#
#.....$......<............#
#.........................#
#..*..........$...$.......#
#.........................#
#.......$.................#
###########################