#############################################
#$.............$.............$.......#...@..#
#....................................#......#
#.*..######.............$....#########......#
#...$#$.........######...............#......#
######..........#....#...............#......#
#..*.#.....######....#.....######...........#
#....#$....#.........#.....#....#...........#
#$...#.....#.........#.....#....######......#
#....#..........#....#..*..#.$.......#....$.#
#....#..........#....#######.........#......#
#....############...$................#..*...#
#.............h.#..............#.....########
#...............#...........$..#.....#......#
######..........################.....#......#
#.$..........>..........$..#.........#..#...#
#............<.............#.........#*.#...#
#.......#..................#...$.....####...#
#.......#.....####.....#####................#
#...^...#........#..........>....$..........#
#$......#........#!.........<..........$....#
#############################################